111111111
1E001C101
1X001C001
100P0C0C1
111111111