1111111111111
100100000C0C1
100001111C001
1P0011E000001
1111111111111