1111111111111
100100000C0C1
100001101C001
1C0011EP10001
1111111111111