1111111111111111111
1E000C0CC000CC00C01
10C010C0X0C0C100C01
10C01C0100C0C101C01
10C0110100C0C001C01
100P0C0C0CC00C01C01
1111111111111111111