1111111111111111111111111111111111
100001000000000C00000C000000000001
1010010010100000101001000000010101
1010010010101010001001000000010101
1010010010101010001001000000010101
1010010010101010001001000000010101
1PE000000C00C0000000000000000001C1
1111111111111111111111111111111111