1111111111111111111
1P0CCC1C001CCC1CCC1
1C1C1C1C101C1C1C1C1
1C1C1C1C1CXC1C1C1C1
1C1C1C1C1C1C1C1C1C1
1C1C1C1C1C1C1C1C1C1
1CCC1CCC1CCC1CCC1E1
1111111111111111111