111111111111111111111
100000P100000000X0001
10000000001C100000101
101111111111111111101
100000C0000000C000101
111111111111111110101
1C000000000C0000001E1
111111111111111111111